1111111111111
1101C00000001
1C0000E001001
1P001000000C1
1111111111111
