1111111111111111111111111111111111
10V000000000000C00000C000000000001
10100101001000E0101001000V00010101
101001001010100000100100000001P101
10000V000C00C00000000000V0000000C1
1111111111111111111111111111111111
