1111111111111
1V010000000C1
10V0011111V01
1P0011E0000C1
1111111111111
