111111111111111111111111111111111111111111111111111111111111
1E00000000000000000000000000000000000000000000000000000000C1
100000000000000000000000000000000000000000000000000000000001
100000000000000000000000000000000000000000000000000000000001
100000000C00000000000000000000000000000000000000000000000001
100000000000000000000000000000000000000000000000000000000001
100000000000000000000000000000000000000000000000000000000001
100000000000000000000000000000000000000000000000000000000001
100000000000000000000000000000000000000000000000000000000001
100000000000000000000000000000000000000000000000000000000001
100000000000111100000000000000000000000000000000000000000001
10000000000010010000000000000000000C000000000000000000000001
100000000000111100000000000000000000000000000000000000000001
100000000000000000000000000000000000000010000000000000000001
10000000000000000000C000000000000000000010000000000000000001
100000000000000000000000000000000000000010000000000000000001
100000000000000000000000000000000000000010000000000000000001
100000000000011111000000000000000000000010000000000000000001
100000000000000000000000000000000000000010000000000000000001
1000000000000000000000000000000000000000C0000000000000000001
100000000000000000000000000000000000000000000000000000000001
100000000000000000000000000000000000000000000000000000000001
100000000000000C00000000000000000000000000000000000000000001
100000000000000000000000000000000000000000000000000000000001
100000000000000000000000000000000000000000000000000000000001
1C0000111000100000000000000000000000000000000000000000000001
1C0000000000101000000000000000000000000000000000000000000001
1111111111111010000000000000000C0000000000000000000000000001
1000000000000001000000000000000C0000000000000000000000000001
1011101111111011000000000000000C0000000000000000000000000001
101000000000000101000000000000000000000000000000000000000001
101000000011111100110000000000000000000000000000000000000001
1P10000000000000000100000000000000000000000000000000000C0001
111111111111111111111111111111111111111111111111111111111111
