1111111111111111111111111111111111
1E0000000000V00C00000C000000000001
101001V1001V0000101001000V00010101
1010010010101010001001V0000001P101
100000000C00CV000V000000000V0000C1
11111011011011011011011011C0111111
1C010000000000000000100000000110C1
100C100000C0000000001010000V0110V1
10VV010C0111000C000011110C1000V001
10C01C11VVVVV1C1000000000010000001
10V000000000000V000010100010001VC1
1111111111111111111111111111111111
