1111111111111
100111P000001
1000001111001
1C0010E0000C1
1111111111111
