1111111111111
100111P000C01
10V0001111001
1C0010E000001
1111111111111
